; level 0
w32
h32
00000000000000000000000000000000
00000000000000000000000000000000
00000000000000000000000000000000
00000000000000000000000000000000
00000000000000000000000000000000
00000000000000000000000000RRRRRR
00000000000000000000000000U00000
00000000000000000000000RRRU00000
00000000000000000000000U00000000
00000000000000000RRD00RU00000000
00000000000000000U0RRRU000000000
00000000000000000U00000000000000
00000000000000000U00000000000000
00000000000000000U00000000000000
00000000000000000U00000000000000
00000000000000000U00000000000000
00000000000000000U00000000000000
00000000000000000U00000000000000
000000000RRD0000RU00000000000000
000000000U0RD000U000000000000000
000000000U00RD0RU000000000000000
000000000U000RRU0000000000000000
000000000U0000000000000000000000
000000000ULL00000000000000000000
00000000000U00000000000000000000
00000RRRRRRU00000000000000000000
0000RU00000000000000000000000000
000RU000000000000000000000000000
RRRU0000000000000000000000000000
00000000000000000000000000000000
00000000000000000000000000000000
00000000000000000000000000000000

