; level 0
w28
h28

0000000000000000000000000000
0000000000000000000000000000
0000000000000000000000000000
000000000000000000000000RRRR
000000000000000000000000U000
000000000000000000000RRRU000
000000000000000000000U000000
000000000000000RRD00RU000000
000000000000000U0RRRU0000000
000000000000000U000000000000
000000000000000U000000000000
000000000000000U000000000000
000000000000000U000000000000
000000000000000U000000000000
000000000000000U000000000000
000000000000000U000000000000
0000000RRD0000RU000000000000
0000000U0RD000U0000000000000
0000000U00RD0RU0000000000000
0000000U000RRU00000000000000
0000000U00000000000000000000
0000000ULL000000000000000000
000000000U000000000000000000
000RRRRRRU000000000000000000
00RU000000000000000000000000
0RU0000000000000000000000000
RU00000000000000000000000000
0000000000000000000000000000


