; level 0
w28
h28

0000000000000000000000000000
0000000000000000000000000000
0000000000000000000000000000
000000000000000000000000RRRR
000000000000000000000000U000
000000000000000000000RRRU000
000000000000000000000U000000
000000000000000RRD00RU000000
000000000000000U0RRRU0000000
000000000000000U000000000000
000000000000000U000000000000
000000000000000U000000000000
000000000000000U000000000000
000000000000000U000000000000
000000000000000U000000000000
000000000000000U000000000000
0000000RRD0000RU000000000000
0000000U0RD000U0000000000000
0000000U00RD0RU0000000000000
0000000U000RRU00000000000000
0000000U00000000000000000000
0000000ULL000000000000000000
000000000U000000000000000000
000RRRRRRU000000000000000000
00RU000000000000000000000000
0RU0000000000000000000000000
RU00000000000000000000000000
0000000000000000000000000000

; level 1
w28
h28

0000000000000000000000000000
0000000000000000000000000000
0000000000000000000000000000
000000000000000000000000RRRR
000000000000000000000000U000
000000000000000000000RRRU000
000000000000000000000U000000
000000000000000000000UL00000
00000000000000000RRR00U00000
0000000000000000000000U00000
000000000000RRRD000000U00000
000000000000U00D000000U00000
0000000000RRU00D000000U00000
0000000000U0000RRRRRRRU00000
0000000URRU00000000000000000
0000000U00000000000000000000
0000000U00000000000000000000
0000000U00000000000000000000
0000000U00000000000000000000
0000000ULLLLLL00000000000000
0000000000000U00000000000000
0000000000000U00000000000000
000000000RRRRU00000000000000
000000000U000000000000000000
00000URRRU000000000000000000
RRRRRU0000000000000000000000
0000000000000000000000000000
0000000000000000000000000000

; level 2
w28
h28

0000000000000000000000000000
0000000000000000000000000000
0000000000000000000000000000
000000000000000000000000RRRR
000000000000000000000000U000
000000000000000000000RRRU000
000000000000000000000U000000
000000000000000000000UL00000
0000000000000000000000U00000
000000000000RRRD000000U00000
000000000000U00D000000U00000
0000000000RRU00D000000U00000
0000000000U0000RRRRRRRU00000
0000000RRRU00000000000000000
0000000U00000000000000000000
0000000U00000000000000000000
0000000U00000000000000000000
0000000U00000000000000000000
0000000ULLLLLLLLLLLLLL000000
000000000000000000000U000000
000000000000000000000U000000
000000000RRRRRRRRD000U000000
000000000U0000000D000U000000
00000RRRRU0000000D000U000000
00000U00000000000D000U000000
00000U00000000000RRRRU000000
RRRRRU0000000000000000000000
0000000000000000000000000000